SSSSSSSSSSSSSSSSSSSSSSSSSSSSSSSSSSSSSSSSSSSSSSSSSSSSSSSSSSSSSSSSSSSSSSSSSSSSSSSSSSSSSSSSSSSSSSSSSSSSSSSSSSSSSSSSSSSSSS
S---------------------------Xe---TX--------------------XXXXXXXXXXXXXXXXXXXXXXX----Xe---TX-k------------e--e-T-e------S
S---------------------------X--X--X----XXXXXXXXXXXX-----XXXXXXXX-----XXXXXXXXX----X--X--X--X--------XXXXXXXXXXXXX----S
S-----e---------------------X--X--X----X--e--------------XXXXXX------XXXXXXXXX----X--X--X--X--------XXXXXXXXXXXXX----S
S---------------------------X--X--X----XT-e---------------XXXXTe-----L-e--e-------X--X--X--X--------XXXXX----XXXX----S
S------k--------------------X--X--X----X--e----------------XXTe------XXXXXXXXX----X--X--X--X----e---XXXXX-T--XXXX----S
S-----------XXXXXXXXXXX-----X--X--X----XXXXXXXXXXXX-------XXXXTe-----XXXXXXXXX----X--X--X--X--------XXXXX-T--XXXX-e--D
S-----------X---------X-----X--X--X----XT--e----e------XXXXXXXXXXXXXXXXXXXXXXX----X--X--X--X--------XXXXX----XXXXXXXXS
S-----------X--T--e---X-----X--X--X----XT----e---------XXXXXXXXXXXXXXXXXXXXXXX----X--X--X--X--------XXXXXXXXXXXXXXXXXS
S-----------X--T--e---X-----X--X--X----XXXXXXXXXXXX----XXXXXXXXXXXXXXXXXXXXXXX----X--X--X--X----e---XXXXXXXXXXXXXXXXXS
S-----S-----X---------L-----X--X-eX----X-T--------D----XXXXXXXXXXXXXXX------------X--X-eX--X----XXXXXXXe---XX-------TS
S--@--------XXXXXXXXXXX--------X-------X-T--------------e-----e----e----TT-----------X-----X-------------X----eX----TS
SSSSSSSSSSSSSSSSSSSSSSSSSSSSSSSSSSSSSSSSSSSSSSSSSSSSSSSSSSSSSSSSSSSSSSSSSSSSSSSSSSSSSSSSSSSSSSSSSSSSSSSSSSSSSSSSSSSSSS