SSSSSSSSSSSSSSSSSSSSSSSSSSSSSSSSSSSSSSSSSSSSSSSSSSSSSSSSSSSSSSSSSSSSSSSSSSSSSSSSSSSSSSSSSSSSSSSSSSSSSSSSSSSSSSSSSSSSSS
S---------------------------Xs---TX--------------------XXXXXXXXXXXXXXXXXXXXXXX----Xs---TX-K------------s--s-T-s------S
S------------------s--------X--X--X----XXXXXXXXXXXX-----XXXXXXXX-----XXXXXXXXX----X--X--X--X--------XXXXXXXXXXXXX----S
S---------------------------X--X--X----X--s--------------XXXXXX------XXXXXXXXX----X--X--X--X--------XXXXXXXXXXXXX----S
S------------------s--------X--X--X----XT-s---------------XXXXTs-----L-s--s-------X--X--X--X--------XXXXX----XXXX----S
S------K--------------------X--X--X----X--s----------------XXTE------XXXXXXXXX----X--X--X--X----s---XXXXX-TU-XXXX----S
S-----------XXXXXXXXXXX-----X--X--X----XXXXXXXXXXXX-------XXXXTs-----XXXXXXXXX----X--X--X--X--------XXXXX-T--XXXX-s--D
S-----T-----X---------X-----X--X--X----XT--s----s------XXXXXXXXXXXXXXXXXXXXXXX----X--X--X--X--------XXXXX----XXXXXXXXS
S-----T-----X--T--s---X-----X--X--X----XT----s---------XXXXXXXXXXXXXXXXXXXXXXX----X--X--X--X--------XXXXXXXXXXXXXXXXXS
S-----T-----X--T--s---X-----X--X--X----XXXXXXXXXXXX----XXXXXXXXXXXXXXXXXXXXXXX----X--X--X--X----s---XXXXXXXXXXXXXXXXXS
S-----T-----X---------L-----X--X-sX----X-TXXXXXXXXX----XXXXXXXXXXXXXXX------------X--X-sX--X----XXXXXXXs---XX-------TS
S--@--T-----XXXXXXXXXXX--------X-------X-TXXXXXXXXX-X-----s-----s----s----TT---------X-----X-------------X----sX----TS
SSSSSSSSSSSSSSSSSSSSSSSSSSSSSSSSSSSSSSSSSSSSSSSSSSSSSSSSSSSSSSSSSSSSSSSSSSSSSSSSSSSSSSSSSSSSSSSSSSSSSSSSSSSSSSSSSSSSSS