SSSSSSSSSSSS
S----------S
S----------S
S----------S
S----------S
S---------UD
S----------S
S----------S
S----------S
S----------S
S----------S
S-@--------S
SSSSSSSSSSSS