SSSSSSSSSSSS
S---T--T---S
S---s-s--s-S
SXXXDXXXXXXS
S----------S
S---------sD
S----------S
S----------S
S----------S
S----------S
S----------S
S-@--------S
SSSSSSSSSSSS