SSSSSSSSSSSS
S-TTTKS----S
S-----D----S
S-----S-E--S
S-E---S----S
S-----S----D
S-----S----S
SSSSSLSSSSSS
S--s--s----S
S----------S
S----------S
S-@-------KS
SSSSSSSSSSSS